R 640 480
NO ./textures/wall_n.xpm
SO ./textures/wall_s.xpm
WE ./textures/wall_w.xpm
EA ./textures/wall_e.xpm
S ./textures/barrel.xpm
F 255,255,255
C 255,255,255
         1111111111111111111111111
        100000000000000000000000001
         1100000000000000000000001
        1000000000000000000000001
011111110000000000000000000000001
 100000000000000000000000000001111
  10000000000002N10000000000001
  10000000000000000000000000001
   10000000000000000000000000001
    10000000000000000000000000001
     10000000000000000001010000001
     11000000110101001111011110101
      11110111 1110101 101111010001
      01111110 0111110 011111111110