R 1930 1000
NO ./textures/wall_n.xpm
SO ./textures/wall_s.xpm
WE ./textures/wall_w.xpm
EA ./textures/wall_e.xpm
S ./textures/barrel.xpm
F 255,255,255
C 255,255,255

     11111111111
     10100000001
1111110000111111
11112000001
   1000000111111
10110200W00000011
1001000000000000111
1111111000011100001
      1100011111111
       11111111111
