R 640 480
NO ./textures/wall_n.xpm
SO ./textures/wall_s.xpm
WE ./textures/wall_w.xpm
EA ./textures/wall_e.xpm
S ./textures/barrel.xpm
F 00,153,15
C 255,255,255
111111
100001
100N01
111111