R 640 480
NO ./images/NO.xpm
SO ./images/SO.xpm
WE ./images/WE.xpm
EA ./images/EA.xpm
S ./images/ITEM.xpn
F 00,153,15
C 255,255,255

1111
110S
1110