R 640 480
NO ./textures/wall_n.xpm
SO ./textures/wall_s.xpm
WE ./textures/wall_w.xpm
EA ./textures/wall_e.xpm
S ./textures/barrel.xpm
F 255,255,255
C 255,255,255
1111111111111111111111111111111111
1000S22222222222222222222221
1110001111111111111111111111111111
111100011111111111111111111111111111
1000000000000000000000000000000001
1110001111111111111111111111111111
110001111111111111111111111111111
1000000000000000000000000000000001
1110001111111111111111111111111111
11100011111111111111111111111111111
10000000000000000000000000000000011111111111111111111101111111111111
1000000000000000000000000000000000000000000000000000000000001
11111111111111111111111111111111111111111111111111111111111111111111

