R 640 480
NO ./textures/wall_n.xpm
SO ./textures/wall_s.xpm
WE ./textures/wall_w.xpm
EA ./textures/wall_e.xpm
S ./textures/barrel.xpm
F 00,153,15
C 255,255,255
1111111111
1222000001
1000000001
1000000001
10000W0001
1000000001
1000000001
1000000001
1111111111